a-, an-	not, without	Ancient Greek ἀ-/ἀν- (a-/an-), not, without	analgesic, apathy
ab-	from; away from	Latin	abduction
abdomin-	Of or relating to the abdomen	Latin abdōmen, abdomen, fat around the belly	abdomen, abdominal
-ac	pertaining to	Greek -ακός (-akos)	cardiac, hydrophobiac
acanth-	thorn or spine	Ancient Greek ἄκανθα (ákantha), thorn	acanthion, acanthocyte, acanthoma, acanthulus
acou- [1]	Of or relating to hearing	Greek ἀκούειν (akoúein), ἀκουστικός (akoustikós), of or for hearing	acoumeter, acoustician, hyperacusis
acr-	extremity, topmost	Greek ἄκρον (akron), highest or farthest point	acrocrany, acromegaly, acroosteolysis, acroposthia
-acusis	hearing	Greek ἀκουστικός (akoustikós), of or for hearing	paracusis
-ad	toward, in the direction of		dorsad
ad-	at, increase, on, toward	Latin	adduction
aden-	Of or relating to a gland	Ancient Greek ἀδήν, ἀδέν- (adēn, aden-), an acorn; a gland	adenocarcinoma, adenology, adenotome, adenotyphus
adip-	Of or relating to fat or fatty tissue	Latin (adeps, adip-), fat	Adipocyte
adren-	Of or relating to adrenal glands	Latin	adrenal artery
-emia (BrE)	blood condition	Greek ἀναιμία, without blood	Anemia
aer(o)-	air, gas	Greek ἀήρ, ἀέρος	Aerosinusitis
aesthesi- (BrE)	sensation	Greek αἴσθησις	Anesthesia
-al	pertaining to	Latin -alis	abdominal, femoral
alb-	Denoting a white or pale color	Latin albus, white	Albino
alge(si)-	pain	Greek ἄλγος	Analgesic
-algia, alg(i)o-	pain	Greek	Myalgia
all-	Denoting something as different, or as an addition	Ancient Greek ἄλλος (allos), another, other	Alloantigen, allopathy
ambi-	Denoting something as positioned on both sides; describing both of two	Latin (ambi-, ambo), both, on both sides	Ambidextrous
amni-	Pertaining to the membranous fetal sac (amnion)	Greek ἄμνιον	Amniocentesis
amph(i)-,	on both sides	Greek ἀμφί (amphi)	Amphicrania, amphismela, amphomycin
amylo-	starchy, carbohydrate-related	Latin amylum (starch)	Amylase, amylophagia
an-	not, without	Greek	Analgesia
ana-	back, again, up	Greek	Anaplasia
an-	anus	Latin	anal
andr-	pertaining to a man	Greek ἀνήρ, ἀνδρ-	Android, andrology, androgen
angi-	blood vessel	Greek ἀγγεῖον	angiogram, angioplasty
aniso-	Describing something as unequal	Ancient Greek ἄνῑσος (anīsos), unequal	Anisocytosis, anisotropic
ankyl-, ancyl-	Denoting something as crooked or bent	Ancient Greek ἀγκύλος (ankýlos), crooked, curved	Ankylosis
ante-	Describing something as positioned in front of another thing	Latin (āntē), before, in front of	antepartum
anti-	Describing something as 'against' or 'opposed to' another	Ancient Greek αντι (anti), against	Antibody, antipsychotic
apo-	away, separated from, derived from	Ancient Greek ἀπό	Apoptosis
arch-	first, primitive	Ancient Greek	archinephron
arsen(o)-	Of or pertaining to a male; masculine	Greek (arsein)	arsenoblast
arteri(o)-	Of or pertaining to an artery	Ancient Greek ἀρτηρία (artēría), a wind-pipe, artery (used distinctly versus a vein)	Arteriole, artery
arthr-	Of or pertaining to the joints, limbs	Ancient Greek ἄρθρον (árthron), a joint, limb	Arthritis
articul-	joint	Latin articulus	Articulation
-ary	pertaining to	Latin -arius	biliary tract, coronary
-ase	enzyme	Greek διάστασις, division	Lactase
-asthenia	weakness	Greek, ἀσθένεια	Myasthenia gravis
atel(o)-	imperfect or incomplete development		atelocardia
ather-	fatty deposit, soft gruel-like deposit	ἀθάρη (athárē)	Atherosclerosis
-ation	process	Latin	medication
atri-	an atrium (esp. heart atrium)	Latin	atrioventricular
aur-	Of or pertaining to the ear	Latin (auris), the ear	Aural
aut-	self	Greek αὐτο-	Autoimmune
aux(o)-	increase; growth		Auxocardia: enlargement of the heart, auxology
axill-	Of or pertaining to the armpit (uncommon as a prefix)	Latin (axilla), armpit	Axilla
azo(to)-	nitrogenous compound		azothermia: raised temperature due to nitrogenous substances in blood
